;LEVEL 1
    #####
    #   #
    #$  #
  ###  $##
  #   $  #
### # ## #######
#   # ##      @#
# $           $#
##### ### # # .#
    #     ######
    #######
;LEVEL 2
############
#    #     ###
#    # $  $  #
#    #$####  #
#.$@     ##  #
#    # #  $ ##
###### ##$ $ #
  # $  $ $ $ #
  #    #     #
  ############
;LEVEL 3
        ########
        #      #
        # $#$ ##
        # $  $#
        ##  $ #
######### $ # ##
#      ## $  $ #
##.$@    $  $  #
#      #########
########